{
 "meta": {
   "author": "lonelykm",
   "name": "vittuman256",
   "width": 10,
   "height": 10,
   "spawn": [200, 200],
   "gravity": 10
 },
  "levels": [
    [[1,1,1,1,1,1,1,1,1,1],
    [1,0,0,0,0,0,0,0,0,1],
    [1,0,0,0,0,0,0,0,0,1],
    [1,0,0,1,0,0,0,0,0,1],
    [1,0,1,1,1,0,0,0,0,1],
    [1,0,0,0,0,0,1,0,0,1],
    [1,0,0,0,0,1,1,0,2,1],
    [1,1,1,0,1,1,1,0,0,1],
    [1,0,0,0,0,0,0,0,0,1],
    [1,1,1,1,1,1,1,1,1,1]]
    ]
}