{
 "meta": {
   "author": "zeez",
   "name": "happyboii",
   "width": 10,
   "height": 10,
   "spawn": [400, 200],
   "gravity": 20
 },
  "levels": [
    [[1,1,1,1,1,1,1,1,1,1],
    [1,0,0,0,0,0,0,0,0,1],
    [1,0,0,0,0,0,0,0,0,1],
    [1,0,0,0,0,0,0,0,0,1],
    [1,0,0,1,0,0,1,0,0,1],
    [1,0,0,0,0,0,0,0,0,1],
    [1,0,1,0,0,0,0,1,0,1],
    [1,0,0,1,1,1,1,0,0,1],
    [1,0,0,0,0,0,0,0,1,1],
    [1,1,1,1,1,1,1,1,1,1]]
    ]
}